W  W  W  W  E  W  W  W  W  W  W  W  W  W  E  W  W  W  W 
W  D  D  D  D  D  D  D  D  W  D  D  D  D  D  D  D  D  W  
W  W  W  W  D  W  W  W  W  W  W  W  W  W  D  W  W  W  W
W  D  D  D  D  D  D  D  D  D  D  D  D  D  D  D  D  D  W
W  D  W  W  D  W  W  D  W  W  W  D  W  W  D  W  W  D  W
E  D  D  D  D  D  D  D  D  D  D  D  D  D  D  D  D  D  E
W  D  W  D  W  D  W  D  G  G  G  D  W  D  W  D  W  D  W
W  D  W  D  W  D  W  D  W  G  W  D  W  D  W  D  W  D  W
W  D  W  D  W  D  W  D  W  D  W  D  W  D  W  D  W  D  W
W  D  W  D  W  D  W  D  W  D  W  D  W  D  W  D  W  D  W
W  D  W  W  W  D  W  D  W  D  W  D  W  D  W  D  W  D  W
W  D  W  D  W  D  W  D  W  D  W  D  W  D  W  D  W  D  W
W  D  W  D  W  D  W  D  W  D  W  D  W  D  W  D  W  D  W
W  D  W  D  W  D  W  D  W  D  W  D  W  D  W  D  W  D  W
W  D  W  D  W  D  W  D  W  D  W  D  W  D  W  D  W  D  W
E  D  D  D  D  D  D  D  D  D  D  D  D  D  D  D  D  D  E
W  D  W  W  D  W  W  D  W  W  W  D  W  W  D  W  W  D  W
W  D  D  D  D  D  D  D  D  D  D  D  D  D  D  D  D  D  W
W  W  W  W  D  W  W  W  W  W  W  W  W  W  D  W  W  W  W
W  D  D  D  D  D  D  D  D  W  D  D  D  D  D  D  D  D  W
W  W  W  W  E  W  W  W  W  W  W  W  W  W  E  W  W  W  W 